5,5,5,5,5,5,5,5,5,5,5,5,5,5,5,5,5,5,5,5,5,5,5,5,5,5,5,5,5,5
5,5,5,5,5,5,5,0,0,0,0,0,0,0,0,0,0,0,0,0,0,0,0,5,5,5,5,5,5,5
5,5,5,5,5,5,0,0,0,0,0,0,0,0,0,0,0,0,0,0,0,0,0,0,5,5,5,5,5,5
5,5,5,5,5,5,0,0,0,0,0,0,0,0,0,0,0,0,0,0,0,0,0,0,5,5,5,5,5,5
5,5,5,5,5,5,0,0,0,0,0,0,0,0,0,0,0,0,0,0,0,0,0,0,5,5,5,5,5,5
5,5,5,5,5,5,0,0,0,0,0,0,0,0,0,0,0,0,0,0,0,0,0,0,5,5,5,5,5,5
5,5,5,5,5,5,0,0,0,0,0,0,0,0,0,0,0,0,0,0,0,0,0,0,5,5,5,5,5,5
5,5,5,5,5,5,0,0,0,0,0,0,0,0,0,0,0,0,0,0,0,0,0,0,5,5,5,5,5,5
5,5,5,5,5,5,0,0,0,0,0,0,0,0,0,0,0,0,0,0,0,0,0,0,5,5,5,5,5,5
5,5,5,5,5,5,0,0,0,0,0,0,0,0,0,0,0,0,0,0,0,0,0,0,5,5,5,5,5,5
5,5,5,5,5,5,0,0,0,0,0,0,0,0,0,0,0,0,0,0,0,0,0,0,5,5,5,5,5,5
5,5,5,5,5,5,0,0,0,0,0,0,0,0,0,0,0,0,0,0,0,0,0,0,5,5,5,5,5,5
5,5,5,5,5,5,0,0,0,5,5,5,5,5,5,5,5,5,5,5,5,0,0,0,5,5,5,5,5,5
5,5,5,5,5,5,0,0,0,0,5,5,5,5,5,5,5,5,5,5,0,0,0,0,5,5,5,5,5,5
5,5,5,5,5,5,0,0,0,0,0,0,0,0,0,0,0,0,0,0,0,0,0,5,5,5,5,5,5,5
5,5,5,5,5,5,0,0,0,0,0,0,0,0,0,0,0,0,0,0,0,0,0,0,5,5,5,5,5,5
5,5,5,5,5,5,0,0,0,0,0,0,0,0,0,0,0,0,0,0,0,0,0,0,5,5,5,5,5,5
5,5,5,5,5,5,0,0,0,0,0,0,0,0,0,0,0,0,0,0,0,0,0,0,5,5,5,5,5,5
5,5,5,5,5,5,0,0,0,0,0,0,0,0,0,0,0,0,0,0,0,0,5,5,5,5,5,5,5,5
5,5,5,5,5,5,0,0,0,0,0,0,0,0,0,0,0,0,0,0,0,0,0,5,5,5,5,5,5,5
5,5,5,5,5,5,0,0,0,0,0,0,0,0,0,0,0,0,0,0,0,0,0,0,5,5,5,5,5,5
5,5,5,5,5,5,0,0,0,0,0,0,0,0,0,0,0,0,0,0,0,0,0,0,5,5,5,5,5,5
5,5,5,5,5,5,5,5,0,0,0,0,0,0,0,0,0,0,0,0,0,0,0,0,5,5,5,5,5,5
5,5,5,5,5,5,5,0,0,0,0,0,0,0,0,0,0,0,0,0,0,0,0,0,5,5,5,5,5,5
5,5,5,5,5,5,0,0,0,0,0,0,0,0,0,0,0,0,0,0,0,0,0,0,5,5,5,5,5,5
5,5,5,5,5,5,0,0,0,0,0,0,0,0,0,0,0,0,0,0,0,0,0,0,5,5,5,5,5,5
5,5,5,5,5,5,0,0,0,0,0,0,0,0,0,0,0,0,0,0,0,0,0,0,5,5,5,5,5,5
5,5,5,5,5,5,5,5,5,5,5,5,5,0,0,0,0,5,5,5,5,5,5,5,5,5,5,5,5,5
5,5,5,5,5,5,5,5,5,5,5,5,0,0,0,0,0,0,5,5,5,5,5,5,5,5,5,5,5,5
5,5,5,5,5,5,5,5,0,0,0,0,0,0,0,0,0,0,0,0,0,0,5,5,5,5,5,5,5,5
5,5,5,5,5,5,5,0,0,0,0,0,0,0,0,0,0,0,0,0,0,0,0,5,5,5,5,5,5,5
5,5,5,5,5,5,0,0,0,0,0,0,0,0,0,0,0,0,0,0,0,0,0,0,5,5,5,5,5,5
5,5,5,5,5,5,0,0,0,0,0,0,0,0,0,0,0,0,0,0,0,0,0,0,5,5,5,5,5,5
5,5,5,5,5,5,0,0,0,0,0,0,0,0,0,0,0,0,0,0,0,0,0,0,5,5,5,5,5,5
5,5,5,5,5,5,0,0,0,0,0,0,0,0,0,0,0,0,0,0,0,0,0,0,5,5,5,5,5,5
5,5,5,5,5,5,0,0,0,0,0,0,0,0,0,0,0,0,0,0,0,0,0,0,5,5,5,5,5,5
5,5,5,5,5,5,0,0,0,0,0,0,0,0,0,0,0,0,0,0,0,0,5,5,5,5,5,5,5,5
5,5,5,5,5,5,0,0,0,0,0,0,0,0,0,0,0,0,0,0,0,0,0,5,5,5,5,5,5,5
5,5,5,5,5,5,0,0,0,0,0,0,0,0,0,0,0,0,0,0,0,0,0,0,5,5,5,5,5,5
5,5,5,5,5,5,0,0,0,0,0,0,0,0,0,0,0,0,0,0,0,0,0,0,5,5,5,5,5,5
5,5,5,5,5,5,5,5,0,0,0,0,0,0,0,0,0,0,0,0,0,0,0,0,5,5,5,5,5,5
5,5,5,5,5,5,5,0,0,0,0,0,0,0,0,0,0,0,0,0,0,0,0,0,5,5,5,5,5,5
5,5,5,5,5,5,0,0,0,0,0,0,0,0,0,0,0,0,0,0,0,0,0,0,5,5,5,5,5,5
5,5,5,5,5,5,0,0,0,0,0,0,0,0,0,0,0,0,0,0,0,0,0,0,5,5,5,5,5,5
5,5,5,5,5,5,0,0,0,0,0,0,0,0,0,0,0,0,0,0,0,0,5,5,5,5,5,5,5,5
5,5,5,5,5,5,0,0,0,0,0,0,0,0,0,0,0,0,0,0,0,0,0,5,5,5,5,5,5,5
5,5,5,5,5,5,0,0,0,0,0,0,0,0,0,0,0,0,0,0,0,0,0,0,5,5,5,5,5,5
5,5,5,5,5,5,0,0,0,0,0,0,0,0,0,0,0,0,0,0,0,0,0,0,5,5,5,5,5,5
5,5,5,5,5,5,5,5,0,0,0,0,0,0,0,0,0,0,0,0,0,0,0,0,5,5,5,5,5,5
5,5,5,5,5,5,5,0,0,0,0,0,0,0,0,0,0,0,0,0,0,0,0,0,5,5,5,5,5,5
5,5,5,5,5,5,0,0,0,0,0,0,0,0,0,0,0,0,0,0,0,0,0,0,5,5,5,5,5,5
5,5,5,5,5,5,0,0,0,0,0,0,0,0,0,0,0,0,0,0,0,0,0,0,5,5,5,5,5,5
5,5,5,5,5,5,0,0,0,0,0,0,0,0,0,0,0,0,0,0,0,0,5,5,5,5,5,5,5,5
5,5,5,5,5,5,0,0,0,0,0,0,0,0,0,0,0,0,0,0,0,0,0,5,5,5,5,5,5,5
5,5,5,5,5,5,0,0,0,0,0,0,0,0,0,0,0,0,0,0,0,0,0,0,5,5,5,5,5,5
5,5,5,5,5,5,0,0,0,0,0,0,0,0,0,0,0,0,0,0,0,0,0,0,5,5,5,5,5,5
5,5,5,5,5,5,5,5,5,5,5,5,5,5,5,5,0,0,0,0,0,0,0,0,5,5,5,5,5,5
5,5,5,5,5,5,5,5,5,5,5,5,5,5,5,0,0,0,0,0,0,0,0,0,5,5,5,5,5,5
5,5,5,5,5,5,0,0,0,0,0,0,0,0,0,0,0,0,0,0,0,0,0,0,5,5,5,5,5,5
5,5,5,5,5,5,0,0,0,0,0,0,0,0,0,0,0,0,0,0,0,0,5,5,5,5,5,5,5,5
5,5,5,5,5,5,0,0,0,0,0,0,0,0,0,0,0,0,0,0,0,0,0,5,5,5,5,5,5,5
5,5,5,5,5,5,0,0,0,0,0,0,0,0,0,0,0,0,0,0,0,0,0,0,5,5,5,5,5,5
5,5,5,5,5,5,0,0,0,0,0,0,0,0,0,0,0,0,0,0,0,0,0,0,5,5,5,5,5,5
5,5,5,5,5,5,0,0,0,0,0,0,0,0,0,0,0,0,0,0,0,0,0,0,5,5,5,5,5,5
5,5,5,5,5,5,0,0,0,0,0,0,0,0,0,0,5,5,5,5,5,5,5,5,5,5,5,5,5,5
5,5,5,5,5,5,0,0,0,0,0,0,0,0,0,0,0,5,5,5,5,5,5,5,5,5,5,5,5,5
5,5,5,5,5,5,5,0,0,0,0,0,0,0,0,0,0,0,0,0,0,1,0,0,5,5,5,5,5,5
5,5,5,5,5,5,0,0,0,0,0,0,0,0,0,0,0,0,0,0,0,1,0,0,5,5,5,5,5,5
5,5,5,5,5,5,0,0,0,0,0,0,0,0,0,0,0,0,0,0,0,1,0,0,5,5,5,5,5,5
5,5,5,5,5,5,0,0,0,0,0,0,0,0,0,0,0,0,0,0,0,1,0,0,5,5,5,5,5,5
5,5,5,5,5,5,5,5,0,0,0,0,0,0,0,0,0,0,0,0,0,1,0,0,5,5,5,5,5,5
5,5,5,5,5,5,5,0,0,0,0,0,0,0,0,0,0,0,0,0,0,1,0,0,5,5,5,5,5,5
5,5,5,5,5,5,0,0,0,0,0,0,0,0,0,0,0,0,0,0,0,1,0,0,5,5,5,5,5,5
5,5,5,5,5,5,0,0,0,0,0,0,0,0,0,0,0,0,0,0,0,1,0,0,5,5,5,5,5,5
5,5,5,5,5,5,0,0,0,0,0,0,0,0,0,0,0,0,0,0,0,1,0,0,5,5,5,5,5,5
5,5,5,5,5,5,5,5,5,5,5,5,5,5,5,0,0,0,0,0,0,1,0,0,5,5,5,5,5,5
5,5,5,5,5,5,5,5,5,5,5,5,5,5,0,0,0,0,0,0,0,1,0,0,5,5,5,5,5,5
5,5,5,5,5,5,0,0,0,0,0,0,1,0,0,0,0,0,0,0,0,1,0,0,5,5,5,5,5,5
5,5,5,5,5,5,0,0,0,0,0,0,1,0,0,0,0,0,0,0,0,1,0,0,5,5,5,5,5,5
5,5,5,5,5,5,0,0,0,0,0,0,1,0,0,0,0,0,0,0,0,1,0,0,5,5,5,5,5,5
5,5,5,5,5,5,0,0,0,0,0,0,1,0,0,0,0,0,5,5,5,5,5,5,5,5,5,5,5,5
5,5,5,5,5,5,0,0,0,0,0,0,1,0,0,0,0,0,0,5,5,5,5,5,5,5,5,5,5,5
5,5,5,5,5,5,0,0,0,0,0,0,1,0,0,0,0,0,0,0,0,0,0,0,5,5,5,5,5,5
5,5,5,5,5,5,0,0,0,0,0,0,1,0,0,0,0,0,0,0,0,0,0,0,5,5,5,5,5,5
5,5,5,5,5,5,0,0,0,0,5,5,5,5,5,5,0,0,0,0,0,0,0,0,5,5,5,5,5,5
5,5,5,5,5,5,0,0,0,0,0,5,5,5,5,0,0,0,0,0,0,0,0,0,5,5,5,5,5,5
5,5,5,5,5,5,0,0,0,0,0,0,0,0,0,0,0,0,0,0,0,0,0,0,5,5,5,5,5,5
5,5,5,5,5,5,0,0,0,0,0,0,0,0,0,0,0,0,0,0,0,0,0,0,5,5,5,5,5,5
5,5,5,5,5,5,5,5,5,5,5,5,5,5,5,5,5,5,0,0,0,0,0,0,5,5,5,5,5,5
5,5,5,5,5,5,5,5,5,5,5,5,5,5,5,5,5,0,0,0,0,0,0,0,5,5,5,5,5,5
5,5,5,5,5,5,5,5,5,5,5,5,5,5,5,5,5,0,0,0,0,0,0,0,5,5,5,5,5,5
5,5,5,5,5,5,5,5,5,5,5,5,5,5,5,5,5,0,0,0,0,0,0,0,5,5,5,5,5,5
5,5,5,5,5,5,5,5,5,5,5,5,5,5,5,5,5,0,0,0,0,0,0,0,5,5,5,5,5,5
5,5,5,5,5,5,5,5,5,5,5,5,5,5,5,5,5,5,5,0,0,0,0,0,5,5,5,5,5,5
5,5,5,5,5,5,5,5,5,5,5,5,5,5,5,5,5,5,0,0,0,0,0,0,5,5,5,5,5,5
5,5,5,5,5,5,5,5,5,5,5,5,5,5,5,5,5,5,0,0,0,0,0,0,5,5,5,5,5,5
5,5,5,5,5,5,5,5,5,5,5,5,5,5,5,5,5,5,0,0,0,0,0,0,5,5,5,5,5,5
5,5,5,5,5,5,5,5,5,5,5,5,5,5,5,5,5,5,0,0,0,0,5,5,5,5,5,5,5,5
5,5,5,5,5,5,5,5,5,5,5,5,5,5,5,5,5,5,0,0,0,5,5,5,5,5,5,5,5,5
5,5,5,5,5,5,5,5,5,5,5,5,5,5,5,5,5,5,0,0,0,5,5,5,5,0,0,0,5,5
5,5,5,5,5,5,5,5,5,5,5,5,5,5,5,5,5,5,0,0,0,0,1,0,0,0,0,0,0,5
5,5,5,5,5,5,5,5,5,5,5,5,5,5,5,5,5,5,5,0,0,0,1,0,0,0,0,0,0,5
5,5,5,5,5,5,5,5,5,5,5,5,5,5,5,5,5,5,5,0,0,0,1,0,0,0,5,5,5,5
5,0,0,0,0,0,0,0,0,0,0,0,0,0,0,0,0,0,0,0,0,0,1,0,0,0,0,1,0,5
5,0,0,0,0,0,0,0,0,0,0,0,0,0,0,0,0,0,0,0,0,0,1,0,0,0,0,1,0,5
5,0,0,0,0,5,5,5,5,5,5,5,5,5,5,5,5,5,5,5,5,5,5,5,5,0,0,1,0,5
5,0,0,0,0,5,5,5,5,5,5,5,5,5,5,5,5,5,5,5,5,5,1,5,0,0,0,1,0,5
5,0,0,0,0,5,5,5,5,5,5,5,5,5,5,5,5,5,5,5,5,0,1,0,0,0,0,1,0,5
5,0,0,0,0,0,5,5,5,5,5,5,5,5,5,5,5,5,5,5,0,0,1,0,0,0,0,1,0,5
5,5,5,0,0,0,0,5,5,5,5,5,5,5,5,5,5,5,5,5,5,5,5,5,5,0,0,1,0,5
5,5,0,0,0,0,0,0,5,5,5,5,5,5,5,5,5,5,5,5,5,5,5,5,0,0,0,1,0,5
5,0,0,0,0,0,0,0,0,0,0,0,0,0,0,0,0,0,0,0,0,0,0,0,0,0,0,1,0,5
5,0,0,0,0,0,0,0,0,0,0,0,0,0,0,0,0,0,0,0,0,0,0,0,0,0,0,1,0,5
5,0,0,0,0,5,5,5,5,5,5,5,5,5,0,0,0,0,0,0,0,0,0,0,5,5,2,3,2,5
5,0,0,0,0,0,5,5,5,5,5,5,5,5,5,5,0,0,0,0,0,0,0,5,5,5,5,5,5,5
5,0,0,0,0,0,0,5,5,5,5,5,5,5,5,5,5,5,5,5,5,5,5,5,5,5,5,5,5,5
5,0,0,0,0,0,0,0,5,5,5,5,5,5,5,5,5,5,5,5,5,5,5,5,5,5,5,5,5,5
5,0,0,0,0,0,0,0,0,5,5,5,5,5,5,5,5,5,5,5,5,5,5,5,5,5,5,5,5,5
5,5,5,0,0,0,0,0,0,5,5,5,5,5,5,5,5,5,5,5,5,5,5,5,5,5,5,5,5,5
5,5,0,0,0,0,0,0,0,5,5,5,5,5,5,5,5,5,5,5,5,5,5,5,5,5,5,5,5,5
5,0,0,0,0,0,0,0,0,5,5,5,5,5,5,5,5,5,5,5,5,5,5,5,5,5,5,5,5,5
5,0,0,0,0,0,0,0,0,5,5,5,5,5,5,5,5,5,5,5,5,5,5,5,5,5,5,5,5,5
5,0,0,0,0,0,0,0,0,5,5,5,5,5,5,5,5,5,5,5,5,5,5,5,5,5,5,5,5,5
5,0,0,0,0,5,5,5,5,5,5,5,5,5,5,5,5,5,5,5,5,5,5,5,5,5,5,5,5,5
5,0,0,0,0,0,5,5,5,5,0,0,0,0,0,0,0,0,0,0,0,0,1,0,5,5,5,5,5,5
5,0,0,0,0,0,0,1,0,0,0,0,0,0,0,0,0,0,0,0,0,0,1,0,5,5,5,5,5,5
5,0,0,0,0,0,0,1,0,0,0,0,0,0,0,0,0,0,0,0,0,0,1,0,5,5,5,5,5,5
5,5,5,0,0,0,0,1,0,0,0,0,0,0,0,0,0,0,0,0,0,0,1,0,5,5,5,5,5,5
5,5,0,0,0,0,0,1,0,0,0,0,5,5,5,5,5,5,0,0,0,0,1,0,5,5,5,5,5,5
5,0,0,0,0,0,0,1,0,0,0,0,0,5,5,5,5,0,0,0,0,0,1,0,5,5,5,5,5,5
5,0,0,0,0,0,0,1,0,0,0,0,0,0,1,0,0,0,0,0,0,0,1,0,5,5,5,5,5,5
5,0,0,0,0,0,0,1,0,0,0,0,0,0,1,0,0,0,0,0,0,0,1,0,5,5,5,5,5,5
5,0,0,0,5,5,5,5,5,5,5,0,0,0,1,0,0,0,0,0,5,5,5,5,5,5,5,5,5,5
5,0,0,0,0,5,5,5,5,5,0,0,0,0,1,0,0,0,0,0,0,5,5,5,5,5,5,5,5,5
5,0,0,0,0,0,0,0,0,0,0,0,0,0,1,0,0,0,0,0,0,0,0,5,5,5,5,5,5,5
5,0,0,0,0,0,0,0,0,0,0,0,0,0,1,0,0,0,0,0,0,0,0,0,5,5,5,5,5,5
5,5,5,5,5,5,5,5,5,5,5,5,5,5,5,5,5,0,0,0,0,0,0,0,5,5,5,5,5,5
5,5,5,5,5,5,5,5,5,5,5,5,5,5,5,5,0,0,0,0,0,0,0,0,5,5,5,5,5,5
5,5,5,5,5,5,5,5,5,5,5,5,5,5,5,0,0,0,0,0,0,0,0,0,5,5,5,5,5,5
5,5,5,5,5,5,5,5,5,5,5,5,5,5,0,0,0,0,0,0,0,0,0,0,5,5,5,5,5,5
5,5,5,5,5,5,5,5,5,5,5,5,0,0,0,0,0,0,0,0,0,0,5,5,5,5,5,5,5,5
5,5,5,5,5,5,5,5,5,5,0,0,0,0,0,0,0,0,0,0,0,0,0,5,5,5,5,5,5,5
5,5,5,5,5,5,0,0,0,0,0,0,0,0,0,0,0,0,0,0,0,0,0,0,5,5,5,5,5,5
5,5,5,5,5,5,0,0,0,0,0,0,0,0,0,0,0,0,0,0,0,0,0,0,5,5,5,5,5,5
5,5,5,5,5,5,0,0,0,5,5,5,5,5,5,5,5,5,5,5,5,0,0,0,5,5,5,5,5,5
5,5,5,5,5,5,0,0,0,0,5,5,5,5,5,5,5,5,5,5,0,0,0,0,5,5,5,5,5,5
5,5,5,5,5,5,0,0,0,0,0,0,0,0,0,0,0,0,0,0,0,0,0,0,5,5,5,5,5,5
5,5,5,5,5,5,0,0,0,0,0,0,0,0,0,0,0,0,0,0,0,0,0,0,5,5,5,5,5,5
5,5,5,5,5,5,0,0,0,0,0,0,0,0,0,0,0,0,0,0,0,0,0,0,5,5,5,5,5,5
5,5,5,5,5,5,5,5,0,0,0,0,0,0,0,0,0,0,0,0,0,0,0,0,5,5,5,5,5,5
5,5,5,5,5,5,5,0,0,0,0,0,0,0,0,0,0,0,0,0,0,0,0,0,5,5,5,5,5,5
5,5,5,5,5,5,0,0,0,0,0,0,0,0,0,0,0,0,0,0,0,0,0,0,5,5,5,5,5,5
5,5,5,5,5,0,0,0,0,0,0,0,0,0,0,0,0,0,0,0,0,0,0,0,5,5,5,5,5,5
5,5,5,5,0,0,0,0,0,0,0,0,0,0,0,0,0,0,0,0,0,0,5,5,5,5,5,5,5,5
5,5,5,0,0,0,0,0,0,0,0,0,0,0,0,0,0,0,0,0,0,0,0,5,5,5,5,5,5,5
5,5,5,0,0,0,0,0,0,0,0,0,0,0,0,0,0,0,0,0,0,0,0,0,5,5,5,5,5,5
5,5,5,0,0,0,0,0,0,0,0,0,0,0,0,0,0,0,0,0,0,0,0,0,5,5,5,5,5,5
5,5,5,0,0,0,0,0,5,5,5,5,5,5,5,5,5,0,0,0,0,0,0,0,5,5,5,5,5,5
5,5,5,0,0,0,0,0,0,5,5,5,5,5,5,5,0,0,0,0,0,0,0,0,5,5,5,5,5,5
5,5,5,0,0,0,0,0,0,0,1,0,0,0,1,0,0,0,0,0,0,0,5,5,5,5,5,5,5,5
5,5,5,0,0,0,0,0,0,0,1,0,0,0,1,0,0,0,0,0,0,0,0,5,5,5,5,5,5,5
5,5,5,5,0,0,0,0,0,0,1,0,0,0,1,0,0,0,0,0,0,0,0,0,5,5,5,5,5,5
5,5,5,5,0,0,0,0,0,0,1,0,0,0,1,0,0,0,0,0,0,0,0,0,5,5,5,5,5,5
5,5,5,5,0,0,0,0,0,0,1,0,0,0,1,0,0,0,0,0,0,0,0,0,5,5,5,5,5,5
5,5,5,5,0,0,0,0,0,0,1,0,0,5,5,5,5,5,5,5,0,0,0,0,5,5,5,5,5,5
5,5,5,5,5,0,0,0,0,0,1,0,0,0,5,5,5,5,5,0,0,0,0,0,5,5,5,5,5,5
5,5,5,5,5,0,0,0,0,0,1,0,0,0,0,0,0,0,0,0,0,0,0,0,5,5,5,5,5,5
5,5,5,5,5,0,0,0,0,0,1,0,0,0,0,0,0,0,0,0,0,0,0,0,5,5,5,5,5,5
5,5,5,5,5,0,0,0,0,0,1,0,0,0,0,0,0,0,0,0,0,0,0,0,5,5,5,5,5,5
5,5,5,5,5,0,0,0,5,5,5,5,5,0,0,0,0,0,0,0,0,0,0,0,5,5,5,5,5,5
5,5,5,5,5,0,0,0,0,5,5,5,5,5,0,0,0,0,0,0,0,0,0,0,5,5,5,5,5,5
5,5,5,5,5,5,0,0,0,0,0,0,0,0,0,0,0,0,0,0,0,0,0,0,5,5,5,5,5,5
5,5,5,5,5,5,0,0,0,0,0,0,0,0,0,0,0,0,0,0,0,0,0,0,5,5,5,5,5,5
5,5,5,5,5,5,5,0,0,0,0,0,0,0,0,0,0,0,0,0,0,0,0,0,5,5,5,5,5,5
5,5,5,5,5,5,5,0,0,0,0,0,0,0,0,0,0,0,0,0,0,0,0,0,5,5,5,5,5,5
5,5,5,5,5,5,5,0,0,0,0,0,0,0,0,0,0,0,0,0,0,0,0,0,5,5,5,5,5,5
5,5,5,5,5,5,5,0,0,0,0,0,0,0,0,0,0,0,0,0,0,0,0,0,5,5,5,5,5,5
5,5,5,5,5,5,5,5,0,0,0,0,0,0,0,0,0,0,0,0,0,0,0,0,5,5,5,5,5,5
5,5,5,5,5,5,5,0,0,0,0,0,0,0,0,0,0,0,0,0,0,0,5,5,5,5,5,5,5,5
5,5,5,5,5,5,5,0,0,0,0,0,0,0,0,0,0,0,0,0,0,0,0,5,5,5,5,5,5,5
5,5,5,5,5,5,0,0,0,0,0,0,0,0,0,0,0,0,0,0,0,0,0,1,5,5,5,5,5,5
5,5,5,5,5,5,0,0,0,5,5,5,5,5,5,0,0,0,0,0,0,0,0,1,5,5,5,5,5,5
5,5,5,5,5,5,0,0,0,0,5,5,5,5,0,0,0,0,0,0,0,0,0,1,5,5,5,5,5,5
5,5,5,5,5,5,0,0,0,0,0,1,0,0,0,0,0,0,0,0,0,0,0,1,5,5,5,5,5,5
5,5,5,5,5,5,5,0,0,0,0,1,0,0,0,5,5,5,5,5,5,0,0,1,5,5,5,5,5,5
5,5,5,5,5,5,5,0,0,0,0,1,0,0,0,0,5,5,5,5,0,0,0,1,5,5,5,5,5,5
5,5,5,5,5,5,5,0,0,0,0,1,0,0,0,0,1,0,0,0,0,0,0,1,5,5,5,5,5,5
5,5,5,5,5,5,5,0,0,0,0,1,0,0,5,5,5,5,0,0,0,0,0,1,5,5,5,5,5,5
5,5,5,5,5,5,5,5,0,0,0,1,0,0,0,5,5,0,0,0,0,0,0,1,5,5,5,5,5,5
5,5,5,5,5,5,5,0,0,0,0,1,0,0,0,0,1,0,0,0,0,0,0,1,5,5,5,5,5,5
5,5,5,5,5,5,1,0,0,0,0,1,0,0,0,0,1,0,0,0,0,0,0,1,5,5,5,5,5,5
5,5,5,5,5,5,1,0,0,0,0,1,0,0,0,0,1,0,0,0,0,0,0,1,5,5,5,5,5,5
5,5,5,5,5,5,1,0,5,5,5,5,5,5,5,5,5,5,5,5,5,5,0,1,5,5,5,5,5,5
5,5,5,5,5,5,1,0,0,5,5,5,5,5,5,5,5,5,5,5,5,0,0,1,5,5,5,5,5,5
5,5,5,5,5,5,1,0,0,0,0,0,0,0,0,0,0,0,0,0,0,0,0,1,5,5,5,5,5,5
5,5,5,5,5,5,3,2,2,2,2,2,2,2,2,2,2,2,2,2,2,2,2,3,5,5,5,5,5,5
5,5,5,5,5,5,4,4,4,4,4,4,4,4,4,4,4,4,4,4,4,4,4,4,5,5,5,5,5,5
5,5,5,5,5,5,4,4,4,4,4,4,4,4,4,4,4,4,4,4,4,4,4,4,5,5,5,5,5,5
5,5,5,5,5,5,5,4,4,4,4,4,4,4,4,4,4,4,4,4,4,4,4,5,5,5,5,5,5,5
5,5,5,5,5,5,5,5,5,5,5,5,5,5,5,5,5,5,5,5,5,5,5,5,5,5,5,5,5,5
